#######//
#-/M/-#//
#//#//##/
#-/T/-/E/
#/////##/
#-#-/-#//
###///#//
#-/-/-#//
#######//