/////////////
//#E#////////
###/#########
#-/-/-/-/-#-#
#//#//#//##/#
#-/-/-#-/-/-#
#/////#//##/#
#-#-/-/-/-#-#
###///////#/#
#-/-/-/-#-#-#
#///////###/#
#M/-/-/-/T#-#
#////#//////#
#-/-/-/-/-/-#
#############