###############
#-/-/-/-/-/-/-#
#/////////////#
#M#-#T/-/-/-/-#
#/###/////////#
#-/-/-/-/-#-#-#
#/////////###/#
#-/-/-/-/-/-/-#
###/###########
//#E#//////////
///////////////