#######//
#-/M/-#//
#//##/##/
#-/-#-/E/
#//##/##/
#-/T/-#//
#######//